1,58,64,14,8,56,2,3
11 11 11 11 11 11 11 11 11 11 11 11 11 87 11 11 15 11 11 11 11 11 11 11 11 11 13 11 11 11 11 11 87 11 11 11 11 14 11 11 11 11 86 11 11 85 11 11 14 11 11 12 11 11 11 15 11 11 11 11 11 18 19 11 11 11
11 11 11 11 86 11 84 11 11 86 11 11 11 84 84 87 11 84 11 11 11 11 85 11 84 11 11 12 11 14 11 11 11 11 85 11 11 11 13 11 87 11 86 11 11 11 11 11 11 85 11 11 11 11 11 11 11 86 11 12 11 16 17 11 11 11
11 11 11 11 86 11 11 12 11 13 18 19 11 14 11 11 15 11 11 15 11 11 85 11 11 11 86 11 11 87 11 11 11 11 11 11 87 11 11 84 11 11 12 11 15 11 86 11 11 11 11 14 11 86 11 85 85 11 11 11 11 11 11 11 11 11
11 11 11 11 11 22 23 11 84 11 16 17 11 42 43 44 64 45 11 13 11 11 11 14 12 11 11 22 23 11 84 11 85 11 14 11 11 11 11 11 11 14 11 11 11 18 19 67 68 69 13 87 11 22 23 11 11 12 11 11 87 11 11 11 11 11
11 11 11 18 19 20 21 11 11 85 11 12 11 46 47 48 49 50 18 19 11 87 11 84 11 11 15 20 21 11 12 11 11 11 13 86 22 23 12 11 11 11 11 84 11 16 17 70 71 72 11 11 84 20 21 15 86 11 84 11 11 11 18 19 11 11
11 11 11 16 17 11 11 86 11 22 23 11 87 51 52 53 54 55 16 17 86 11 11 85 11 18 19 11 15 13 11 18 19 87 11 11 20 21 11 18 19 85 13 86 11 15 11 73 74 75 11 11 11 11 11 11 11 11 11 14 11 11 16 17 11 11
11 11 11 11 11 12 84 11 15 20 21 11 86 56 57 58 59 60 11 11 11 22 23 85 11 16 17 11 11 84 11 16 17 11 11 84 11 11 11 16 17 11 11 22 23 11 87 76 77 78 12 86 18 19 11 87 85 18 19 86 11 11 11 11 11 11
11 11 11 11 11 11 13 11 11 11 85 11 11 61 62 63 65 66 13 11 11 20 21 11 14 11 11 85 11 11 11 12 11 11 11 11 11 85 11 11 12 11 11 20 21 11 11 79 80 81 11 11 16 17 11 11 11 16 17 11 12 11 11 11 11 11
11 11 11 11 11 85 11 18 19 11 11 30 31 118 3 3 3 119 31 31 31 31 31 31 31 31 31 31 31 31 31 31 31 31 31 31 31 31 31 31 31 31 31 31 31 31 31 31 31 31 31 31 31 31 32 11 13 11 11 11 11 11 11 11 11 11
11 11 18 19 11 14 11 16 17 11 11 28 11 6 2 0 2 10 22 23 11 11 11 84 87 11 11 11 22 23 11 11 11 84 11 18 19 84 11 86 11 85 84 11 11 85 118 3 3 119 84 11 11 87 29 11 86 11 87 11 11 84 18 19 11 11
11 11 16 17 11 11 11 11 12 11 11 28 11 6 0 1 2 10 20 21 188 189 85 11 11 15 11 11 20 21 11 18 19 11 15 16 17 85 22 23 12 11 11 11 15 11 6 1 1 4 119 11 11 11 29 11 11 22 23 11 85 11 16 17 11 11
11 11 11 11 11 86 22 23 11 84 11 28 12 6 1 2 2 10 11 86 190 191 11 18 19 82 83 11 11 11 14 16 17 11 11 85 11 11 20 21 11 87 18 19 11 11 6 2 1 0 10 85 11 84 29 11 14 20 21 11 15 11 11 11 11 11
11 11 11 11 11 11 20 21 13 11 11 28 11 6 1 2 0 10 84 14 6 10 11 16 17 11 11 11 12 11 11 87 11 12 11 11 86 11 11 11 85 11 16 17 84 11 6 0 2 0 10 18 19 87 29 13 11 84 11 86 18 19 11 11 11 11
11 11 11 11 11 87 11 11 84 85 11 28 11 6 2 2 0 10 11 11 121 120 13 11 85 14 11 11 82 83 11 11 84 85 11 11 30 31 31 31 31 31 31 31 31 32 6 1 0 2 10 16 17 11 29 11 11 11 12 11 16 17 11 11 11 11
11 11 22 23 11 84 11 12 11 11 14 28 15 6 0 2 1 4 3 3 3 3 3 3 3 3 3 3 3 119 85 11 11 11 15 85 28 118 3 3 3 3 3 3 119 29 6 0 2 2 10 11 14 12 29 11 85 11 11 14 11 11 22 23 11 11
11 11 20 21 11 11 86 11 22 23 11 28 11 6 0 1 1 0 0 0 1 0 2 1 0 0 0 1 0 4 119 11 18 19 11 84 28 6 0 2 0 2 88 0 10 29 6 2 2 1 10 11 11 85 29 11 18 19 11 87 11 86 20 21 11 11
11 11 11 11 13 11 11 15 20 21 11 28 11 121 9 0 2 2 2 2 1 2 1 1 2 1 2 1 1 1 4 119 16 17 11 11 28 6 179 179 2 2 88 0 10 29 6 1 2 0 10 84 13 11 29 13 16 17 11 11 11 84 11 11 11 11
11 11 11 11 11 85 11 11 11 12 11 28 84 11 121 9 2 0 0 0 0 2 0 0 1 0 0 2 0 1 0 10 11 87 14 11 28 6 1 2 0 2 2 0 10 29 6 0 2 2 10 11 11 86 29 11 11 11 11 86 11 11 11 11 11 11
11 11 11 11 11 18 19 87 11 11 13 28 22 23 13 121 7 7 7 7 7 7 7 7 7 7 7 9 1 1 0 10 11 84 11 86 28 6 88 2 2 2 2 2 10 29 6 0 1 1 10 11 12 11 29 14 86 11 85 11 13 18 19 11 11 11
11 11 11 22 23 16 17 11 11 84 11 28 20 21 84 11 85 30 31 31 31 11 11 11 31 31 32 6 1 2 1 10 85 22 23 11 28 6 1 2 2 2 2 0 10 11 6 0 1 1 10 85 18 19 29 11 11 11 11 14 11 16 17 11 11 11
11 11 11 20 21 11 11 84 11 11 11 28 11 11 11 11 11 28 11 11 11 11 11 11 11 87 29 6 2 2 2 10 11 20 21 86 28 6 0 2 1 2 179 0 10 11 6 2 2 1 10 11 16 17 29 11 84 12 11 22 23 11 11 11 11 11
11 11 11 11 12 11 84 11 18 19 15 28 11 85 15 11 84 28 11 15 11 11 14 11 86 11 29 6 2 2 1 10 84 11 85 11 28 6 179 2 1 0 1 88 10 11 6 1 2 0 10 11 11 11 29 11 11 11 11 20 21 11 11 11 11 11
11 11 18 19 11 11 14 11 16 17 11 28 84 11 11 22 23 28 11 86 87 11 11 13 11 11 29 6 0 2 0 10 22 23 12 11 28 6 0 2 1 0 1 88 10 29 6 1 2 2 10 14 84 11 29 87 11 11 85 11 12 11 11 11 11 11
11 11 16 17 11 84 11 13 11 87 11 28 11 12 11 20 21 28 11 11 11 11 11 11 11 11 29 6 0 1 0 10 20 21 11 84 28 121 7 7 7 7 7 7 120 29 6 0 2 0 10 11 11 13 29 11 84 11 15 11 12 11 11 11 11 11
11 11 11 11 11 22 23 85 15 11 11 28 11 11 85 11 11 28 11 11 11 11 12 11 86 11 29 6 1 1 0 10 84 86 18 19 24 25 25 25 25 25 25 25 25 26 6 1 2 1 10 86 11 85 29 11 13 11 14 84 86 11 22 23 11 11
11 11 11 11 11 20 21 11 11 86 11 28 13 18 19 11 14 28 87 11 15 11 11 13 11 14 29 6 0 2 0 10 11 11 16 17 11 11 11 86 11 11 82 83 11 11 6 0 2 0 10 22 23 84 29 11 12 11 11 11 11 11 20 21 11 11
11 11 11 11 11 11 11 12 11 11 11 28 84 16 17 11 85 24 25 25 25 25 25 25 25 25 26 6 0 0 1 10 11 85 11 11 11 82 83 11 14 11 11 13 11 12 6 0 1 0 10 20 21 11 29 11 22 23 87 11 18 19 11 11 11 11
11 11 11 11 12 86 11 18 19 11 14 28 11 11 118 3 3 3 3 3 3 3 3 3 3 3 3 5 2 1 2 4 3 3 3 3 3 3 3 3 3 3 3 3 3 3 5 0 1 0 4 3 3 119 29 11 20 21 11 11 16 17 11 11 11 11
11 11 11 11 11 11 13 16 17 87 11 28 11 118 5 0 1 0 0 0 0 0 1 0 1 0 0 1 2 0 1 0 0 0 0 0 0 1 1 1 0 2 2 0 0 0 1 2 1 1 0 0 0 10 29 11 11 11 13 15 14 11 11 11 11 11
11 11 11 11 14 15 11 11 11 86 11 28 118 5 0 2 2 2 2 1 1 2 1 1 2 1 1 2 2 2 2 2 2 2 2 2 2 1 1 0 2 2 0 1 2 0 1 2 2 1 2 2 0 10 29 11 85 11 12 11 11 85 11 11 11 11
11 11 11 22 23 84 11 11 84 22 23 28 6 0 2 2 0 0 0 0 0 0 0 0 0 2 1 2 1 1 1 1 1 1 2 2 2 1 0 0 2 2 0 0 0 1 0 2 2 2 2 2 2 10 29 11 11 14 11 11 86 11 11 11 11 11
11 11 11 20 21 87 11 12 11 20 21 28 6 2 2 1 0 8 7 7 7 7 7 7 7 7 7 7 7 7 7 7 7 7 7 7 7 7 7 9 0 0 0 8 7 7 7 7 7 7 7 7 7 120 29 15 87 11 84 11 11 11 11 11 11 11
11 11 11 11 11 18 19 11 85 11 11 28 6 0 2 2 8 120 11 11 15 11 11 11 11 15 11 11 11 85 18 19 11 84 11 11 12 11 85 6 1 1 0 10 30 31 31 31 31 31 31 31 31 31 29 11 11 11 11 22 23 11 18 19 11 11
11 11 11 11 11 16 17 14 11 15 11 28 6 1 1 1 10 30 31 31 31 31 31 31 31 31 31 31 32 11 16 17 11 11 87 13 11 11 11 6 2 2 1 10 28 11 87 11 11 11 11 11 12 11 29 11 84 12 11 20 21 11 16 17 11 11
11 11 11 11 11 11 11 11 84 11 11 28 6 0 2 2 10 11 118 3 3 3 3 3 3 3 3 119 29 86 11 11 14 11 18 19 11 11 84 6 0 2 0 10 28 11 11 14 11 11 11 87 87 11 29 13 11 11 11 11 12 11 11 11 11 11
11 11 11 11 86 12 11 11 11 85 11 28 6 0 2 1 10 12 6 0 0 0 2 2 2 0 0 10 29 11 11 85 85 11 16 17 11 15 87 6 1 2 0 10 28 11 87 11 11 11 86 11 11 86 29 11 86 11 11 87 15 11 11 11 11 11
11 11 11 11 13 11 22 23 11 11 11 28 6 2 2 1 10 11 6 0 2 179 1 1 2 88 88 10 29 11 11 22 23 11 11 11 11 11 11 6 0 1 1 10 28 11 11 11 87 11 11 86 11 11 29 11 11 18 19 11 14 11 11 11 11 11
11 11 22 23 11 11 20 21 87 86 11 28 6 2 0 2 10 28 6 0 2 2 2 2 2 2 2 10 29 11 11 20 21 87 12 11 85 13 11 6 1 2 1 10 28 11 11 11 87 11 11 11 11 11 29 11 11 16 17 11 85 11 11 11 11 11
11 11 20 21 11 12 15 11 11 11 14 28 6 2 1 2 10 28 6 0 2 1 1 1 1 179 0 10 29 12 11 15 11 11 11 22 23 11 84 6 0 2 2 10 28 11 86 11 11 11 13 15 11 11 29 12 11 13 11 11 84 11 22 23 11 11
11 11 11 11 11 11 11 85 11 84 11 28 6 1 2 2 10 28 6 88 2 2 1 1 179 0 0 10 29 11 84 11 86 85 11 20 21 11 11 6 2 2 2 10 28 11 86 11 11 12 11 11 11 11 29 11 14 11 86 11 11 11 20 21 11 11
11 11 11 11 18 19 13 11 11 11 87 28 6 2 2 0 10 28 6 0 88 2 1 0 1 88 0 10 29 11 11 85 11 11 11 11 85 11 11 6 0 2 2 10 28 86 11 11 11 11 11 87 11 11 29 22 23 11 11 15 11 87 11 11 11 11
11 11 11 11 16 17 11 86 15 11 11 28 6 0 0 0 10 28 6 0 2 179 2 2 0 2 1 10 29 11 11 18 19 11 14 11 11 11 85 6 0 0 0 10 24 25 25 25 25 11 11 11 11 11 29 20 21 11 85 11 18 19 11 11 11 11
11 11 11 11 11 11 11 84 11 18 19 28 6 1 0 2 10 28 6 0 0 0 2 2 1 179 88 10 29 11 86 16 17 11 11 84 87 15 11 6 0 1 0 4 3 3 3 3 3 3 3 3 3 119 29 11 11 84 11 11 16 17 11 11 11 11
11 11 18 19 11 11 12 11 11 16 17 28 6 0 2 2 10 28 121 7 7 7 7 7 7 7 7 120 29 11 11 11 11 85 11 11 22 23 11 6 2 2 2 0 0 0 0 2 0 1 0 0 0 10 29 11 86 11 11 12 11 11 11 11 11 11
11 11 16 17 11 85 14 11 13 11 11 28 6 2 2 2 10 24 25 25 25 25 25 25 25 25 25 25 26 11 84 11 11 11 11 11 20 21 11 6 1 1 2 1 1 1 1 0 2 2 2 2 2 10 29 11 11 18 19 11 84 22 23 11 11 11
11 11 11 11 11 11 11 86 11 87 11 28 121 9 1 8 120 11 86 85 11 11 11 11 11 11 11 11 85 87 11 11 22 23 11 86 11 11 11 6 0 2 2 1 0 2 2 0 2 2 0 1 2 10 29 11 85 16 17 86 13 20 21 11 11 11
11 11 11 11 11 87 11 22 23 11 11 28 84 121 7 120 11 18 19 84 11 11 82 83 11 12 12 11 11 11 13 11 20 21 11 85 11 11 84 6 2 1 0 8 7 7 7 7 7 7 7 7 7 120 29 11 11 12 11 11 15 11 11 11 11 11
11 11 11 11 11 15 11 20 21 11 12 28 11 11 84 14 11 16 17 11 13 11 84 11 11 11 14 11 11 82 83 11 11 11 11 11 11 14 11 6 2 1 1 10 11 84 87 11 11 85 18 19 15 85 29 11 11 11 11 11 84 11 11 11 11 11
11 11 22 23 13 84 84 11 11 85 11 28 86 85 22 23 85 11 11 85 12 11 11 11 11 82 83 11 11 11 11 11 85 11 11 84 11 11 11 6 0 2 2 10 11 18 19 12 11 11 16 17 11 11 29 11 84 11 22 23 11 11 11 11 11 11
11 11 20 21 11 11 11 11 86 11 11 28 11 11 20 21 11 86 84 11 11 84 13 85 11 11 84 11 11 11 12 11 87 11 15 11 11 86 84 121 7 7 7 120 87 16 17 11 84 86 14 11 84 87 29 11 11 13 20 21 11 11 11 11 11 11
11 11 11 11 86 11 18 19 11 11 11 24 25 25 25 25 25 25 25 25 25 25 25 25 25 25 25 25 25 25 25 25 25 25 25 25 25 25 25 25 25 11 25 25 25 31 31 31 31 31 31 31 31 31 26 11 12 11 11 11 11 11 11 11 11 11
11 11 11 11 11 11 16 17 12 11 84 11 11 11 11 11 11 11 11 13 11 11 11 11 11 11 11 11 11 13 11 11 11 86 11 11 11 11 11 118 3 3 3 119 11 11 11 13 11 11 11 11 12 11 11 86 11 18 19 87 87 11 22 23 11 11
11 11 11 11 14 11 11 11 11 11 85 14 11 85 11 18 19 11 86 11 11 11 11 11 11 86 18 19 11 15 11 14 11 11 87 11 12 11 14 6 0 0 0 10 86 11 84 11 15 11 85 11 18 19 11 85 11 16 17 11 11 11 20 21 11 11
11 11 11 11 11 12 85 87 11 86 11 22 23 11 12 16 17 15 11 22 23 11 84 87 11 11 16 17 11 85 11 11 18 19 11 11 22 23 11 6 0 0 0 10 11 11 12 11 22 23 11 84 16 17 11 12 11 11 11 11 11 11 11 11 11 11
11 11 11 11 11 11 11 13 11 15 11 20 21 11 11 11 11 87 11 20 21 12 11 11 11 14 11 11 11 11 87 11 16 17 84 11 20 21 11 6 0 0 0 10 84 84 11 87 20 21 11 85 11 11 11 87 11 15 86 11 18 19 11 11 11 11
11 11 11 11 11 86 11 11 84 11 87 11 11 13 85 85 11 11 85 11 11 11 15 11 11 11 85 11 11 22 23 11 15 11 11 11 11 85 13 6 0 0 0 10 11 14 85 15 11 11 86 85 11 22 23 11 84 11 11 11 16 17 11 11 11 11
11 11 11 11 15 11 11 12 11 11 11 86 11 84 11 11 14 84 84 11 11 11 86 11 87 11 84 11 86 20 21 11 11 86 11 18 19 11 11 6 0 0 0 10 11 18 19 11 84 11 11 15 11 20 21 11 11 86 11 14 11 11 11 11 11 11
11 11 11 11 11 11 11 11 11 11 11 11 11 11 11 11 11 11 11 11 11 85 11 11 11 11 11 11 11 11 12 11 11 11 13 16 17 11 11 6 0 0 0 10 11 16 17 86 11 11 84 11 12 11 11 11 11 11 11 11 11 11 11 11 11 11

0 0 0 0 0 0 0 0 0 0 0 0 0 0 0 0 0 0 0 0 0 0 0 0 0 0 0 0 0 0 0 0 0 0 0 0 0 0 0 0 0 0 0 0 0 0 0 0 0 0 0 0 0 0 0 0 0 0 0 0 0 0 0 0 0 0
0 0 0 0 0 0 0 0 0 0 0 0 0 0 0 0 0 0 0 0 0 0 0 0 0 0 0 0 0 0 0 0 0 0 0 0 0 0 0 0 0 0 0 0 0 0 0 0 0 0 0 0 0 0 0 0 0 0 0 0 0 0 0 0 0 0
0 0 0 0 0 0 0 0 0 0 0 0 0 0 0 0 0 0 0 0 0 0 0 0 0 0 0 0 0 0 0 0 0 0 0 0 0 0 0 0 0 0 0 0 0 0 0 0 0 0 0 0 0 0 0 0 0 0 0 0 0 0 0 0 0 0
0 0 0 0 0 0 0 0 0 0 0 0 0 0 0 0 0 0 0 0 0 0 0 0 0 0 0 0 0 0 0 0 0 0 0 0 0 0 0 0 0 0 0 0 0 0 0 0 0 0 0 0 0 0 0 0 0 0 0 0 0 0 0 0 0 0
0 0 0 0 0 0 0 0 0 0 0 0 0 0 0 0 0 0 0 0 0 0 0 0 0 0 0 0 0 0 0 0 0 0 0 0 0 0 0 0 0 0 0 0 0 0 0 0 0 0 0 0 0 0 0 0 0 0 0 0 0 0 0 0 0 0
0 0 0 0 0 0 0 0 0 0 0 0 0 0 0 0 0 0 0 0 0 0 0 0 0 0 0 0 0 0 0 0 0 0 0 0 0 0 0 0 0 0 0 0 0 0 0 0 0 0 0 0 0 0 0 0 0 0 0 0 0 0 0 0 0 0
0 0 0 0 0 0 0 0 0 0 0 0 0 0 0 0 0 0 0 0 0 0 0 0 0 0 0 0 0 0 0 0 0 0 0 0 0 0 0 0 0 0 0 0 0 0 0 0 0 0 0 0 0 0 0 0 0 0 0 0 0 0 0 0 0 0
0 0 0 0 0 0 0 0 0 0 0 0 0 0 0 0 0 0 0 0 0 0 0 0 0 0 0 0 0 0 0 0 0 0 0 0 0 0 0 0 0 0 0 0 0 0 0 0 0 0 0 0 0 0 0 0 0 0 0 0 0 0 0 0 0 0
0 0 0 0 0 0 0 0 0 0 0 0 0 0 0 0 0 0 0 0 0 0 0 0 0 0 0 0 0 0 0 0 0 0 0 0 0 0 0 0 0 0 0 0 0 0 0 0 0 0 0 0 0 0 0 0 0 0 0 0 0 0 0 0 0 0
0 0 0 0 0 0 0 0 0 0 0 0 0 0 0 0 0 0 0 0 0 0 0 0 0 0 0 0 0 0 0 0 0 0 1 0 0 0 0 0 0 0 0 0 0 0 0 0 1 0 0 0 0 0 0 0 0 0 0 0 0 0 0 0 0 0
0 0 0 0 0 0 0 0 0 0 0 0 0 0 0 0 0 0 0 0 0 0 0 0 1 0 5 0 0 0 0 0 0 0 0 0 0 0 0 0 0 0 0 0 0 0 0 0 0 0 0 0 0 0 0 0 0 0 0 0 0 0 0 0 0 0
0 0 0 0 0 0 0 0 0 0 0 0 0 0 0 0 0 0 0 0 0 0 0 0 0 0 0 0 0 0 0 0 0 0 0 0 0 0 0 0 0 0 0 0 0 0 0 0 0 0 0 0 0 0 0 0 0 0 0 0 0 0 0 0 0 0
0 0 0 0 0 0 0 0 0 0 0 0 0 0 0 0 0 0 0 0 0 0 0 0 0 0 0 0 0 0 5 0 0 0 0 0 0 0 0 0 0 0 0 0 0 0 0 0 0 0 0 0 0 0 0 0 0 0 0 0 0 0 0 0 0 0
0 0 0 0 0 0 0 0 0 0 0 0 0 0 0 0 0 0 0 0 0 0 0 0 0 0 0 0 0 0 0 0 0 0 0 0 0 0 0 0 0 0 0 0 0 0 0 0 0 0 0 0 0 0 0 0 0 0 0 0 0 0 0 0 0 0
0 0 0 0 0 0 0 0 0 0 0 0 0 0 0 0 0 0 0 0 0 0 0 0 0 0 0 0 0 0 0 0 0 0 0 0 0 0 0 0 0 0 0 0 0 0 0 5 0 0 0 0 0 0 0 0 0 0 0 0 0 0 0 0 0 0
0 0 0 0 0 0 0 0 0 0 0 0 0 0 0 0 0 0 0 0 0 0 5 0 0 0 0 0 0 0 0 0 0 0 0 0 0 0 2 0 0 5 0 0 0 0 0 0 0 0 0 0 0 0 0 0 0 0 0 0 0 0 0 0 0 0
0 0 0 0 0 0 0 0 0 0 0 0 0 0 0 0 0 0 0 0 0 0 0 0 0 0 0 0 0 0 0 0 0 0 0 0 0 0 0 0 0 0 0 0 0 0 0 0 0 0 0 0 0 0 0 0 0 0 0 0 0 0 0 0 0 0
0 0 0 0 0 0 0 0 0 0 0 0 0 0 0 0 0 0 0 0 0 0 0 0 0 0 0 0 0 0 0 0 0 0 0 0 0 0 0 0 5 0 0 0 0 0 0 0 0 0 0 0 0 0 0 0 0 0 0 0 0 0 0 0 0 0
0 0 0 0 0 0 0 0 0 0 0 0 0 0 0 0 0 0 0 0 0 0 0 0 0 0 0 0 0 0 0 0 0 0 0 0 0 0 0 0 0 0 0 0 0 0 0 0 0 0 0 0 0 0 0 0 0 0 0 0 0 0 0 0 0 0
0 0 0 0 0 0 0 0 0 0 0 0 0 0 0 0 0 0 0 0 0 0 0 0 0 0 0 0 0 0 0 0 0 0 0 0 0 0 0 0 5 0 0 0 0 0 0 0 0 0 0 0 0 0 0 0 0 0 0 0 0 0 0 0 0 0
0 0 0 0 0 0 0 0 0 0 0 0 0 0 0 0 0 0 0 1 0 5 0 0 0 0 0 0 0 0 0 0 0 0 0 0 0 0 0 0 0 0 0 0 0 0 0 0 0 0 0 0 0 0 0 0 0 0 0 0 0 0 0 0 0 0
0 0 0 0 0 0 0 0 0 0 0 0 0 0 0 0 0 0 5 0 0 0 0 0 0 0 0 0 0 0 0 0 0 0 0 0 0 0 0 0 0 0 0 0 0 5 0 0 0 0 0 0 0 0 0 0 0 0 0 0 0 0 0 0 0 0
0 0 0 0 0 0 0 0 0 0 0 0 0 0 0 0 0 0 0 0 0 0 0 0 0 0 0 0 0 0 5 0 0 0 0 0 0 0 0 1 0 0 0 0 0 0 0 0 0 0 0 0 0 0 0 0 0 0 0 0 0 0 0 0 0 0
0 0 0 0 0 0 0 0 0 0 0 0 0 0 5 0 0 0 0 0 0 0 0 5 0 0 0 0 0 0 0 0 0 0 0 0 0 0 0 0 0 0 0 0 0 0 0 0 0 0 0 0 0 0 0 0 0 0 0 0 0 0 0 0 0 0
0 0 0 0 0 0 0 0 0 0 0 0 1 0 0 0 0 0 0 0 5 0 0 0 0 0 0 0 0 0 0 0 0 0 0 0 0 0 0 0 0 0 0 0 0 0 0 0 0 0 0 0 0 0 0 0 0 0 0 0 0 0 0 0 0 0
0 0 0 0 0 0 0 0 0 0 0 0 0 0 0 0 0 0 0 0 0 0 0 0 0 0 0 0 0 0 0 0 0 0 0 0 0 0 0 0 0 0 0 0 0 0 0 0 0 0 0 0 0 0 0 0 0 0 0 0 0 0 0 0 0 0
0 0 0 0 0 0 0 0 0 0 0 0 0 0 0 0 0 0 0 0 0 0 0 0 0 0 0 0 0 0 0 0 0 0 0 0 0 0 0 0 0 0 0 0 0 0 0 0 0 0 0 0 0 0 0 0 0 0 0 0 0 0 0 0 0 0
0 0 0 0 0 0 0 0 0 0 0 0 0 0 0 0 0 0 0 0 0 0 0 0 0 0 0 0 0 0 0 0 0 0 0 0 0 0 0 0 0 0 0 0 0 0 0 0 0 0 0 0 0 0 0 0 0 0 0 0 0 0 0 0 0 0
0 0 0 0 0 0 0 0 0 0 0 0 0 0 0 0 0 0 0 0 0 0 0 0 0 0 0 0 0 1 0 0 0 0 0 0 0 5 0 0 0 0 0 0 0 0 0 0 0 0 0 0 0 0 0 0 0 0 0 0 0 0 0 0 0 0
0 0 0 0 0 0 0 0 0 0 0 0 0 0 0 0 0 0 0 0 0 0 0 0 0 0 0 0 0 0 0 0 0 0 0 0 0 0 0 0 0 0 0 0 0 0 0 0 0 5 0 0 0 99 0 0 0 0 0 0 0 0 0 0 0 0
0 0 0 0 0 0 0 0 0 0 0 0 0 0 0 0 0 0 0 0 0 0 0 0 0 0 5 0 0 0 0 0 0 0 0 0 0 0 0 0 0 0 0 0 0 0 0 0 0 0 0 0 0 0 0 0 0 0 0 0 0 0 0 0 0 0
0 0 0 0 0 0 0 0 0 0 0 0 0 0 0 0 0 0 0 0 0 0 0 0 0 0 0 0 0 0 0 0 0 0 0 0 0 0 0 0 0 0 0 0 0 0 0 0 0 0 0 0 0 0 0 0 0 0 0 0 0 0 0 0 0 0
0 0 0 0 0 0 0 0 0 0 0 0 0 0 0 0 0 0 0 0 0 0 0 0 0 0 0 0 0 0 0 0 0 0 0 0 0 0 0 0 0 0 0 0 0 0 0 0 0 0 0 0 0 0 0 0 0 0 0 0 0 0 0 0 0 0
0 0 0 0 0 0 0 0 0 0 0 0 0 0 5 0 0 0 0 0 0 0 0 0 0 0 0 0 0 0 0 0 0 0 0 0 0 0 0 0 0 0 0 0 0 0 0 0 0 0 0 0 0 1 0 0 0 0 0 0 0 0 0 0 0 0
0 0 0 0 0 0 0 0 0 0 0 0 0 0 0 0 0 0 0 0 0 0 0 0 0 0 0 0 0 0 0 0 0 0 0 0 0 0 0 0 5 0 0 0 0 0 0 0 0 0 0 0 0 0 0 0 0 0 0 0 0 0 0 0 0 0
0 0 0 0 0 0 0 0 0 0 0 0 0 0 0 0 0 0 0 0 0 0 0 0 5 0 0 0 0 0 0 0 0 0 0 0 0 0 0 0 0 0 0 0 0 1 0 0 0 5 0 2 0 0 0 0 0 0 0 0 0 0 0 0 0 0
0 0 0 0 0 0 0 0 0 0 0 0 0 0 0 0 0 0 5 0 0 0 0 0 0 0 0 0 0 0 0 0 0 0 0 0 0 0 0 0 0 0 0 0 0 0 0 0 0 0 0 0 0 0 0 0 0 0 0 0 0 0 0 0 0 0
0 0 0 0 0 0 0 0 0 0 0 0 0 0 0 0 0 0 0 0 0 0 0 0 0 0 0 0 0 0 0 0 0 0 0 0 0 0 0 0 0 0 0 0 0 0 0 0 0 0 0 0 0 5 0 0 0 0 0 0 0 0 0 0 0 0
0 0 0 0 0 0 0 0 0 0 0 0 0 0 0 0 0 0 0 0 0 5 0 0 0 0 0 0 0 0 0 0 0 0 0 0 0 0 0 0 0 0 0 0 0 0 0 0 0 0 0 0 0 0 0 0 0 0 0 0 0 0 0 0 0 0
0 0 0 0 0 0 0 0 0 0 0 0 0 0 0 0 0 0 0 0 0 0 0 0 0 1 0 0 0 0 0 0 0 0 5 0 0 0 0 0 0 0 0 0 0 0 0 0 0 0 0 0 0 0 0 0 0 0 0 0 0 0 0 0 0 0
0 0 0 0 0 0 0 0 0 0 0 0 0 5 0 0 0 0 0 0 0 0 0 0 0 0 0 0 0 0 0 0 1 0 0 0 0 0 0 0 0 0 0 0 0 0 0 0 0 0 5 0 0 0 0 0 0 0 0 0 0 0 0 0 0 0
0 0 0 0 0 0 0 0 0 0 0 0 0 0 0 0 0 0 0 0 0 0 0 5 0 0 0 0 0 0 0 0 0 0 0 0 0 0 0 0 0 0 0 0 0 0 0 0 0 0 0 0 0 0 0 0 0 0 0 0 0 0 0 0 0 0
0 0 0 0 0 0 0 0 0 0 0 0 0 0 0 0 0 0 0 2 0 0 0 0 0 0 0 0 0 0 0 0 0 0 0 0 0 0 0 0 0 0 0 0 0 0 0 0 0 0 0 0 0 0 0 0 0 0 0 0 0 0 0 0 0 0
0 0 0 0 0 0 0 0 0 0 0 0 0 0 0 0 0 0 0 0 0 0 0 0 0 0 0 0 0 0 0 5 1 0 0 0 0 0 0 0 0 0 0 0 0 0 0 0 0 0 0 0 0 0 0 0 0 0 0 0 0 0 0 0 0 0
0 0 0 0 0 0 0 0 0 0 0 0 0 0 0 0 0 0 0 0 0 0 0 0 0 0 0 0 0 0 0 0 0 0 0 0 0 0 0 0 0 0 0 5 0 0 0 0 0 0 0 0 0 0 0 0 0 0 0 0 0 0 0 0 0 0
0 0 0 0 0 0 0 0 0 0 0 0 0 0 1 0 0 0 0 0 0 0 0 1 0 0 5 0 0 0 0 0 0 0 0 0 0 0 0 0 0 0 0 0 0 0 0 0 0 0 0 0 0 0 0 0 0 0 0 0 0 0 0 0 0 0
0 0 0 0 0 0 0 0 0 0 0 0 0 0 99 0 0 0 0 0 0 0 0 0 0 0 5 0 0 0 0 0 0 0 0 0 0 0 0 0 0 0 0 0 0 0 0 0 0 0 0 0 0 0 0 0 0 0 0 0 0 0 0 0 0 0
0 0 0 0 0 0 0 0 0 0 0 0 0 0 0 0 0 0 0 1 0 0 0 0 0 1 0 0 0 0 0 0 0 0 0 0 0 0 0 0 5 0 0 0 0 0 0 0 0 0 0 0 0 0 0 0 0 0 0 0 0 0 0 0 0 0
0 0 0 0 0 0 0 0 0 0 0 0 0 0 0 0 0 0 0 0 5 0 0 0 5 0 0 0 0 0 0 0 0 0 0 0 0 0 0 0 0 0 0 0 0 0 0 0 0 0 0 0 0 0 0 0 0 0 0 0 0 0 0 0 0 0
0 0 0 0 0 0 0 0 0 0 0 0 0 0 0 0 0 0 0 0 0 0 1 0 0 0 0 0 0 0 0 0 0 0 0 0 0 0 0 0 0 0 0 0 0 0 0 0 0 0 0 0 0 0 0 0 0 0 0 0 0 0 0 0 0 0
0 0 0 0 0 0 0 0 0 0 0 0 0 0 0 0 0 0 0 0 0 0 0 0 0 0 0 0 0 0 0 0 0 0 0 0 0 0 0 0 0 3 0 0 0 0 0 0 0 0 0 0 0 0 0 0 0 0 0 0 0 0 0 0 0 0
0 0 0 0 0 0 0 0 0 0 0 0 0 0 0 0 0 0 0 0 0 0 0 0 0 0 0 0 0 0 0 0 0 0 0 0 0 0 0 0 0 0 0 0 0 0 0 0 0 0 0 0 0 0 0 0 0 0 0 0 0 0 0 0 0 0
0 0 0 0 0 0 0 0 0 0 0 0 0 0 0 0 0 0 0 0 0 0 0 0 0 0 0 0 0 0 0 0 0 0 0 0 0 0 0 0 0 0 0 0 0 0 0 0 0 0 0 0 0 0 0 0 0 0 0 0 0 0 0 0 0 0
0 0 0 0 0 0 0 0 0 0 0 0 0 0 0 0 0 0 0 0 0 0 0 0 0 0 0 0 0 0 0 0 0 0 0 0 0 0 0 0 0 0 0 0 0 0 0 0 0 0 0 0 0 0 0 0 0 0 0 0 0 0 0 0 0 0
0 0 0 0 0 0 0 0 0 0 0 0 0 0 0 0 0 0 0 0 0 0 0 0 0 0 0 0 0 0 0 0 0 0 0 0 0 0 0 0 0 0 0 0 0 0 0 0 0 0 0 0 0 0 0 0 0 0 0 0 0 0 0 0 0 0
0 0 0 0 0 0 0 0 0 0 0 0 0 0 0 0 0 0 0 0 0 0 0 0 0 0 0 0 0 0 0 0 0 0 0 0 0 0 0 0 0 0 0 0 0 0 0 0 0 0 0 0 0 0 0 0 0 0 0 0 0 0 0 0 0 0
0 0 0 0 0 0 0 0 0 0 0 0 0 0 0 0 0 0 0 0 0 0 0 0 0 0 0 0 0 0 0 0 0 0 0 0 0 0 0 0 0 0 0 0 0 0 0 0 0 0 0 0 0 0 0 0 0 0 0 0 0 0 0 0 0 0
0 0 0 0 0 0 0 0 0 0 0 0 0 0 0 0 0 0 0 0 0 0 0 0 0 0 0 0 0 0 0 0 0 0 0 0 0 0 0 0 0 0 0 0 0 0 0 0 0 0 0 0 0 0 0 0 0 0 0 0 0 0 0 0 0 0
0 0 0 0 0 0 0 0 0 0 0 0 0 0 0 0 0 0 0 0 0 0 0 0 0 0 0 0 0 0 0 0 0 0 0 0 0 0 0 0 0 0 0 0 0 0 0 0 0 0 0 0 0 0 0 0 0 0 0 0 0 0 0 0 0 0