TEST,8,8,4,4,4,1,1
0 1 2 0 2 0 1 0
0 1 0 2 0 0 0 1
1 18 19 0 2 1 0 0
0 16 17 2 0 0 1 2
1 0 1 2 0 0 2 0
0 1 0 0 2 0 1 0
0 0 1 1 0 2 0 2
1 0 1 1 2 0 1 0

0 0 0 0 0 0 0 0
0 0 0 0 0 0 1 0
0 0 0 0 0 0 0 0
0 0 0 0 0 0 2 0
0 0 0 0 0 0 0 0
0 0 0 0 0 0 0 0
0 3 0 0 99 0 0 0
0 0 0 0 0 0 0 0