3 3 3 3 3 3 3 3 3 3 3 3 3 3 3 3 3 3 3 3 3 3 3 3 3 3 3 3 3 3
3 0 0 0 0 0 0 0 0 0 0 0 0 0 0 0 0 0 0 0 0 0 0 0 0 0 0 0 0 3
3 0 3 3 3 3 0 0 0 0 0 0 0 0 0 0 1 0 0 0 6 6 0 6 6 0 6 6 0 3
3 0 3 3 3 3 0 0 0 0 0 0 0 0 0 0 1 0 0 0 6 0 6 6 0 6 6 0 0 3
3 0 3 3 3 3 0 0 0 0 0 0 0 0 0 0 1 0 0 0 0 6 6 0 6 6 0 6 0 3
3 0 3 3 3 3 0 0 0 0 0 0 0 0 0 0 1 0 0 0 6 6 0 6 6 0 6 6 0 3
3 0 0 0 0 0 0 0 0 0 0 0 0 0 0 0 1 0 0 0 6 0 6 6 0 6 6 0 0 3
3 0 0 0 0 0 0 0 0 0 0 0 0 0 0 0 1 0 0 0 0 6 6 0 6 6 0 6 0 3
3 0 0 0 0 0 0 0 0 0 0 0 0 0 0 0 1 0 0 0 6 6 0 6 6 0 6 6 0 3
3 0 0 0 0 0 0 0 0 0 0 0 0 0 1 1 1 1 1 0 0 0 0 0 0 0 0 0 0 3
3 0 4 4 4 4 4 4 4 4 4 4 4 4 1 1 1 1 1 0 0 0 0 0 0 0 0 0 0 3
3 0 2 2 2 2 2 2 2 2 2 2 2 2 1 1 1 1 1 0 0 0 0 0 0 0 0 0 0 3
3 0 2 2 2 2 2 2 2 2 2 2 2 2 1 1 1 1 1 0 0 0 0 0 0 0 0 0 0 3
3 0 2 2 2 2 2 2 2 2 2 2 2 2 1 1 1 1 1 1 1 1 1 1 1 1 0 0 0 3
3 0 2 2 2 2 2 2 2 2 2 2 2 2 0 0 1 0 0 0 0 0 0 0 0 0 0 0 0 3
3 0 2 2 2 2 7 7 7 7 2 2 2 2 1 1 1 0 0 0 0 5 0 5 0 5 0 0 0 3
3 0 2 2 2 2 2 2 2 2 2 2 2 2 0 0 1 0 0 0 5 0 5 0 5 0 5 0 0 3
3 0 2 2 2 2 2 2 2 2 2 2 2 2 0 0 1 0 0 0 0 5 0 5 0 5 0 0 0 3
3 0 2 2 2 2 2 2 2 2 2 2 2 2 0 0 1 0 0 0 5 0 5 0 5 0 5 0 0 3
3 0 2 2 2 2 2 2 2 2 2 2 2 2 0 0 1 0 0 0 0 5 0 5 0 5 0 0 0 3
3 0 4 4 4 4 4 4 4 4 4 4 4 4 0 0 1 0 0 0 5 0 5 0 5 0 5 0 0 3
3 0 0 0 0 0 0 0 0 0 0 0 0 0 0 0 1 0 0 0 0 5 0 5 0 5 0 0 0 3
3 0 0 0 0 0 0 0 0 0 0 0 0 0 0 0 1 0 0 0 0 0 0 0 0 0 0 0 0 3
3 0 0 0 0 0 0 0 0 0 0 0 0 0 0 0 0 0 0 0 0 0 0 0 0 0 0 0 0 3
3 3 3 3 3 3 3 3 3 3 3 3 3 3 3 3 3 3 3 3 3 3 3 3 3 3 3 3 3 3
