1,20,15,14,8,56,2,3
11 11 11 11 11 11 11 11 11 11 11 11 11 11 11 11 11 11 11 11
11 11 11 195 196 197 198 199 200 201 11 11 11 11 11 11 11 11 11 11
11 11 11 202 203 204 205 206 207 208 11 11 11 11 11 11 11 11 11 11
11 11 11 209 210 211 212 213 214 215 11 11 11 11 11 11 11 11 11 11
11 11 11 216 217 217 217 217 217 217 11 11 11 11 11 11 11 11 11 11
11 11 11 11 11 11 11 11 11 11 11 11 11 11 11 11 11 11 11 11
11 11 11 11 11 11 11 11 11 11 11 11 11 11 11 11 11 11 11 11
11 11 11 11 11 18 19 11 11 11 11 18 19 11 11 11 11 11 11 11
11 11 11 11 11 16 17 11 11 11 11 16 17 11 11 11 11 11 11 11
11 11 11 11 11 11 11 11 11 11 11 11 11 11 11 11 11 11 11 11
11 11 11 11 11 11 11 11 11 11 11 11 11 11 11 11 11 11 11 11
11 11 11 11 11 11 11 11 11 11 11 11 11 11 11 11 11 11 11 11
11 11 11 11 11 11 11 11 11 11 11 11 11 11 11 11 11 11 11 11
11 11 11 11 11 11 11 11 11 11 11 11 11 11 11 11 11 11 11 11
