3 3 3 3 3 3 3 3 3 3 3 3 3 3 3 3 3 3 3 3 3 3 3 3 3 3 3 3 3 3
3 0 0 0 0 0 0 0 0 0 0 0 0 0 1 1 0 0 0 0 0 0 0 0 0 0 0 0 0 3
3 0 0 0 0 0 0 0 0 0 0 0 0 0 1 1 0 0 0 0 0 0 0 0 0 0 0 0 0 3
3 0 0 0 3 3 3 3 0 0 0 0 0 0 1 1 0 0 0 0 3 3 3 3 0 0 0 0 0 3
3 0 0 0 3 3 3 3 0 0 0 0 0 0 1 1 0 0 0 0 3 3 3 3 0 0 0 0 0 3
3 0 0 0 3 3 3 3 0 0 0 0 0 0 1 1 8 8 8 8 3 3 3 3 0 0 0 0 0 3
3 0 0 0 3 3 3 3 0 0 0 0 0 0 1 1 6 6 6 6 6 3 3 3 4 0 0 0 0 3
3 0 0 0 0 0 1 1 1 1 1 1 1 1 1 1 7 7 7 7 7 8 0 0 0 0 0 0 0 3
3 0 0 0 0 0 1 1 1 1 1 1 4 1 1 1 7 7 7 7 7 8 0 0 0 0 0 0 0 3
3 0 0 0 0 4 0 0 0 0 0 0 0 0 1 1 6 6 6 6 6 8 0 0 0 4 0 0 0 3
3 0 0 0 0 0 0 0 0 4 0 0 0 1 1 1 1 8 8 8 8 8 0 0 0 0 0 0 0 3
3 0 0 0 1 1 1 1 1 1 1 1 1 1 1 1 1 1 1 1 1 1 1 1 1 1 0 0 0 3
3 0 0 0 1 1 1 1 1 1 1 1 1 1 1 1 1 1 1 1 1 1 1 1 1 1 0 0 0 3
3 0 5 5 5 5 5 1 5 5 5 5 5 0 1 1 0 0 0 0 0 0 0 0 0 0 0 0 0 3
3 0 5 2 2 2 2 1 2 2 2 0 5 0 1 1 0 5 5 5 5 5 5 1 5 5 5 5 5 3
3 0 5 2 2 2 2 1 2 2 2 0 5 0 1 1 0 5 2 2 2 2 2 1 2 2 2 0 5 3
3 0 5 2 2 2 4 1 2 2 2 0 5 0 1 1 0 5 2 2 2 2 2 1 2 2 2 0 5 3
3 0 5 2 2 2 2 1 2 2 2 0 5 0 1 1 0 5 2 2 2 4 2 1 2 2 2 0 5 3
3 0 5 2 2 2 2 1 2 4 2 0 5 0 1 1 0 5 2 2 2 2 2 1 4 2 2 0 5 3
3 0 5 2 2 2 2 1 2 2 4 0 5 0 1 1 0 5 2 2 2 2 2 1 2 2 2 0 5 3
3 0 5 2 2 2 2 1 2 2 2 4 5 5 5 5 5 5 2 2 2 2 2 1 2 2 2 0 5 3
3 0 5 2 2 2 2 1 2 2 2 0 5 0 1 1 0 5 2 2 2 2 2 1 2 2 2 0 5 3
3 0 5 5 5 5 5 1 5 5 5 5 5 0 1 1 0 5 5 5 5 5 5 1 5 5 5 5 5 3
3 0 0 0 0 0 0 0 0 0 0 0 0 0 1 1 0 0 0 0 0 0 0 0 0 0 0 0 0 3
3 3 3 3 3 3 3 3 3 3 3 3 3 3 3 3 3 3 3 3 3 3 3 3 3 3 3 3 3 3
